1111111111111
10010C00000P1
1000011111101
100000E000C01
1111111111111