1111111111111
1001000C00011
1P00000E00001
1111111111111