1111111111111
10010001C00P1
10000111111E1
1000000000001
1111111111111