1111111111111
10010000000C1
1P00000E00001
1111111111111