11111111111111111111111111111111111111111111111111111111111111111111111111
1ECP1